1111111110111
1P01000000E01
1000010000001
100C010000001
1111111111111