1111111111111
1P00010000E01
1000000000E01
100C010000E01
1111111111111