1111111111111   
100100C0000C1
100..11111001
1...11E000001
1111111111111